0 0 

################
#      	  $   .#
#  @           #
#         $   .#
#              #
################